XXXXXXXXXXXXXXXXXXXXXXXXXXXXXXXXXXXXXXXXXXXXXXXXXXXXX
X312323212121323122132321221232321212232133212312223X
X132b21123XXXXXXX21323112321112223123332111331c12231X
X222223331112233131231231221313XXXXXXXX2231233122212X
XXXXXXXXXXXXXXXXXXXXXXXX121321XXXXXXXXXXXXXXXX312321X
X111111122322322212231232233XXXXXXXX2131233123211321X
X321232112332123221233211233211233211233322123322231X
XXXX32123212211322123211233221123321123321123XXXXXXXX
X222222222132121221323123312132123121323213122231312X
X322222113232311122113333a33333312323111222111111111X
X233123131232132121231111111111112121311122222132211X
XXXXXXXXXXXXXXXXXXXXXXXXXXXX213212131232131232313122X
X222222222222222222222222222222222222222222222222222X
X321123221322313212122222222222323111111111111111111X
X111111111111122222222222222222333333333333333311111X
X333333333333222222222222211111111111111222222222211X
X111233333332222222111111123122223111112312221122211X
X3212312131232312321322213131113132323132123e1132323X
X123122132313212131231232131321212123131312313312311X
X332132132131231232131122313131313131321321321312321X
X213123d22221111133311111111111113332221222222312333X
X132131313213213131221123123131323131323121313132321X
XXXXXXXXXXXXXXXXXXXXXXXXXXXXXXXXXXXXXXXXXXXXXXXXXXXXX
