--------------------------------------------------------------------------------------------------------------------------------------------------------------------------------------------------------
--------------------------------------------------------------------------------------------------------------------------------------------------------------------------------------------------------
--------------------------------------------------------------------------------------------------------------------------------------------------------------------------------------------------------
--------------------------------------------------------------------------------------------------------------------------------------------------------------------------------------------------------
--------------------------------------------------------------------------------------------------------------------------------------------------------------------------------------------------------
--------------------------------------------------------------------------------------------------------------------------------------------------------------------------------------------------------
--Bo-------E---o-E--XXXX------o-EE-E-?----XX----o--X----o--M--?-----X---MX------XE----o-oB-X-X---X----o---o---X-EBB---oM-o-?E--XM---X------X-?-o------M?-E---X--------------X-E-B-E-XB-o?-o------E------
---X---ME------BB------M-?-XXM-----oo-B-----o--oX-o----B----B----------o-Xo--oBB--X-X-MX---X-M--o---X---------------E-EX------B-X----------o?----o--o-?--B---B-o------X-B------B-XB-B-----------Xo----v-
---B-B-------X---------M-B-----o--XB--X--?--?-X-XB-----?M-o--o-------B-o---?--------E--X-----X----X----E?--------------?------B-------o-Xo----E---?--XX-?XXBo--B-M-BEoX-----o--BEX--M----X---X--B-?---f-
------?------X---X-?------X----o-------Bo--M----BX------X-------?-----?XX-o----------E-o--M--Xo------------BXE---B-----X-----E-----?X-oXBE---MBB-----B---?-E-----Xo---X---X-B--?--------E----B-E------f-
----------Bo---XB-----B------X-X-X---B----o----------oE-o---o-X-M-----BX-XXB-----X---X---oE---X-X---B----M---------ME-----B----B-o---X-M--??-??--B-----X---B-XM-o--------------------ooEX---B---------f-
----B------BE-----B----?---X-BBoX-B---E---E-X---------B---BE-oBE----------X-------X--XM---X----B----XE--M-X----------E---E----o-?-M--?----EE-?---------X-----oM----E-------X----?-B-X---?--?--E-EX----f-
----X-?X--X-------B-X----XoB--E-------E--B--B----M-----M---?-----XXX----X-------X------o---B---M-Xoo--oo--B-Eo---X------oB--oXX-o-o?-----o---o-B----B-----o-BB---X----EE---oXT---XX-------EB-BB---BX--f-
----B-----B---------M-B--B--X---------XM-----------?---BE-------o---B-B-------B--------M---?----o--X--X---X--------T-----X---?----B---E-------B-----------T--M-M----------?B-|?E-o?------------T----?-f-
m-XX-----X--X--MBB---MM-BX-MXB-----X-oXEM-?--M----Eo--XX--B-X---------o?-o-B-o??-XBX--E?X-E-B-?----EX-X--Xoo----B--|---?--o--B-E--M-oo-oB--Xo-B----E-EXB-o|----T?-B-B---T-oB-|-M--M-XXo-----E--|-T-BM-X-
XXX--XX-XX--XX-XXXXXXXXXXXXX-X-XX-XXX--XXXXX-X--X---X----XX-X-XX--X--X--XXXXXX--XX-X-XX-XX--XX-X-XXX-X--XXXX--XXXXXX-XX---XXX-XXX----X-XXXXX-X-XX-XXXXX--XXXX-X|-XXXXX-X|X---X-X----XXX-X-XXXXXXX-X--XX-
